111111111111111111111
101111010100010000001
101110110110110111101
101101110110110111101
101011110110110111101
100111110110110000001
101011110110110111101
101101110110110111101
101110110110110111101
1011110101101101111P1
111111111111111111111